10 
17
0 0 0 0 0 0 0 0 0 0 0 0 0 0 0 0 0
0 6 1 1 1 1 1 1 1 1 1 1 1 4 4 1 0
0 1 1 1 1 1 1 1 1 1 1 1 1 1 1 1 0
0 1 1 1 1 1 1 3 1 1 1 1 1 2 2 1 0
0 5 1 1 1 1 3 3 3 2 2 7 2 2 1 1 0
0 1 1 2 2 7 2 3 2 2 1 1 1 1 5 1 0
0 1 2 2 4 1 1 1 1 1 1 1 1 1 1 1 0
0 2 2 4 4 1 1 1 1 1 1 1 1 1 6 1 0
0 1 1 1 1 1 1 1 1 1 1 1 1 1 1 1 0
0 0 0 0 0 0 0 0 0 0 0 0 0 0 0 0 0